00000000000000000000000000000000000000000000000
00000000000000000000000000000000000000000000000
00000000000000000000000000000000000000000000000
00000000000000000000000000000000000000000000000
00000000000000000000000000000000000000000000000
00000000000000000000000000000000000000000000000
00000000000099900000000000000000000000000000000
00000000000990000000000000000000000000000000000
00000000000990000000000000000000000000000000000
00000000900905500500700000000000000770000000000
00000999999900000000700000000000000700000000000
00000009999900000000000000000000000777000000000
00000000009900000000000070000000077777000000000
00000000009900005000000777000007790007700000000
00000000009900005000000070000777990009970000000
00000900909900555000000060005799000000090000000
00000009999975555500000060050700990009000000000
00000099999977555550000555555700000909990000000
00099999998077555555000005550799999999990000000
09999999907777555555500005550799999999000000000
00000000077777555555500055555700800999990000000
09900000007777555550500055555077777099900000000
09000000077770550555555555555006667700070000000
00000000000605555555555555555506660777700000000
00555005055555555555500555555555550077777700000
00055555555555555505500000005555555007700070000
00000555550555505555555550005555555500777770000
00000000550555555000000055005550055000000000000
00000000055555550000000005055005555555000000000
00000003000444000000000000000000000555555500000
00000003300444000000000000000000000055555500000
00000005333333333003003300000300003005550000000
00000505000333333033333030000303003000500500000
00005555000333333333333333003333333000555500000
00055550000333333333333333333333333000555500000
00000403333333300033300033333333333333550000000
00033333333333000022200003000300033000555500000
00003333333000000022200000300303333300500500000
00000003333330001111100000300003333300055000000
00000000033330000111111100330003333330000000000
00000000000000001111111000030000000000300000000
00000000003300100111111110030000003333000000000
00000000000000111111111110000000000000000000000
00000000000000001111111000000000000000000000000